111111111111111
100000001000101
111010111010101
100010000010001
101011111111101
101010000000001
101010111110101
101010101010101
101111101011111
101000100000001
101110101110101
100010000010101
101010111010111
101000100010001
111111111111111
